//MAP CONVERTED BY dmm2tgm.py THIS HEADER COMMENT PREVENTS RECONVERSION, DO NOT REMOVE
"a" = (
/turf/template_noop,
/area/template_noop)
"c" = (
/obj/structure/maintenance_loot_structure/toolbox/random{
	pixel_y = 5
	},
/obj/structure/table,
/obj/structure/sign/poster/random/directional/north,
/turf/open/floor/iron/smooth_half,
/area/station/hallway/secondary/entry)
"d" = (
/obj/machinery/door/poddoor/shutters/indestructible/preopen{
	id = "this_one_is_open"
	},
/obj/structure/fluff/tram_rail/floor,
/obj/structure/fans/tiny/invisible,
/turf/open/floor/iron/dark/textured_large,
/area/station/hallway/secondary/entry)
"e" = (
/obj/structure/sign/poster/random/directional/north,
/turf/open/floor/iron/smooth_large,
/area/station/hallway/secondary/entry)
"f" = (
/obj/machinery/door/poddoor/shutters/indestructible/preopen{
	id = "this_one_is_open"
	},
/obj/structure/fans/tiny/invisible,
/turf/open/floor/iron/dark/textured_large,
/area/station/hallway/secondary/entry)
"g" = (
/obj/structure/fluff/tram_rail/electric{
	dir = 1
	},
/obj/effect/turf_decal/stripes/white/line,
/turf/open/floor/plating,
/area/station/hallway/secondary/entry)
"h" = (
/obj/machinery/light/small/directional/north,
/turf/open/floor/iron/smooth_half,
/area/station/hallway/secondary/entry)
"i" = (
/obj/machinery/light/small/directional/north,
/obj/effect/spawner/random/structure/closet_empty/crate,
/turf/open/floor/iron/smooth_half,
/area/station/hallway/secondary/entry)
"j" = (
/obj/structure/fake_stairs/directional/north,
/obj/structure/railing{
	dir = 8
	},
/turf/open/floor/iron/smooth_large,
/area/station/hallway/secondary/entry)
"k" = (
/obj/structure/chair/plastic{
	dir = 8
	},
/turf/open/floor/catwalk_floor/iron_smooth,
/area/station/hallway/secondary/entry)
"l" = (
/turf/open/floor/iron/smooth_corner{
	dir = 4
	},
/area/station/hallway/secondary/entry)
"m" = (
/obj/effect/turf_decal/stripes/white/line{
	dir = 4
	},
/obj/machinery/light/small/red/directional/north,
/turf/open/floor/iron/smooth_half{
	dir = 1
	},
/area/station/hallway/secondary/entry)
"n" = (
/turf/open/floor/catwalk_floor/iron_smooth,
/area/station/hallway/secondary/entry)
"o" = (
/turf/open/floor/iron/smooth_corner{
	dir = 1
	},
/area/station/hallway/secondary/entry)
"q" = (
/obj/machinery/light/small/red/directional/south,
/obj/structure/sign/poster/random/directional/south,
/turf/open/floor/iron/smooth_half,
/area/station/hallway/secondary/entry)
"r" = (
/obj/effect/turf_decal/stripes/white/line{
	dir = 8
	},
/obj/machinery/light/small/red/directional/south,
/turf/open/floor/iron/smooth_half{
	dir = 1
	},
/area/station/hallway/secondary/entry)
"s" = (
/turf/open/floor/plating,
/area/station/hallway/secondary/entry)
"t" = (
/obj/structure/fluff/tram_rail/electric/anchor{
	dir = 1
	},
/obj/effect/turf_decal/stripes/white/line,
/turf/open/floor/plating,
/area/station/hallway/secondary/entry)
"v" = (
/obj/effect/turf_decal/stripes/white/line{
	dir = 8
	},
/turf/open/floor/iron/smooth_half{
	dir = 1
	},
/area/station/hallway/secondary/entry)
"w" = (
/turf/open/floor/iron/smooth_half,
/area/station/hallway/secondary/entry)
"x" = (
/obj/machinery/light/small/directional/north,
/obj/structure/table,
/obj/structure/maintenance_loot_structure/computer_tower/random{
	pixel_y = 4;
	pixel_x = 8
	},
/obj/structure/sign/calendar/directional/north,
/turf/open/floor/iron/smooth_half,
/area/station/hallway/secondary/entry)
"y" = (
/obj/structure/fluff/tram_rail/electric/anchor,
/obj/effect/turf_decal/stripes/white/line{
	dir = 1
	},
/turf/open/floor/plating,
/area/station/hallway/secondary/entry)
"z" = (
/obj/effect/turf_decal/stripes/white/line{
	dir = 4
	},
/obj/machinery/light/small/red/directional/south,
/turf/open/floor/iron/smooth_half{
	dir = 1
	},
/area/station/hallway/secondary/entry)
"A" = (
/obj/effect/spawner/random/structure/shipping_container,
/turf/open/floor/catwalk_floor,
/area/station/hallway/secondary/entry)
"B" = (
/obj/effect/turf_decal/stripes/white/line{
	dir = 4
	},
/turf/open/floor/iron/smooth_half{
	dir = 1
	},
/area/station/hallway/secondary/entry)
"D" = (
/obj/structure/fluff/tram_rail/electric/anchor,
/obj/effect/turf_decal/stripes/white/line{
	dir = 1
	},
/obj/effect/spawner/random/structure/closet_empty/crate,
/turf/open/floor/plating,
/area/station/hallway/secondary/entry)
"E" = (
/obj/structure/sign/poster/random/directional/south,
/turf/open/floor/iron/smooth_half,
/area/station/hallway/secondary/entry)
"F" = (
/obj/machinery/light/small/red/directional/south,
/turf/open/floor/iron/smooth_half,
/area/station/hallway/secondary/entry)
"G" = (
/obj/machinery/digital_clock/directional/north,
/turf/open/floor/iron/smooth_large,
/area/station/hallway/secondary/entry)
"H" = (
/obj/effect/spawner/random/structure/closet_empty/crate,
/turf/open/floor/iron/smooth_half,
/area/station/hallway/secondary/entry)
"I" = (
/obj/modular_map_connector{
	dir = 1
	},
/turf/closed/indestructible/steel,
/area/station/hallway/secondary/entry)
"J" = (
/obj/effect/spawner/random/structure/closet_empty/crate,
/turf/open/floor/catwalk_floor,
/area/station/hallway/secondary/entry)
"K" = (
/obj/structure/fluff/tram_rail/electric/anchor{
	dir = 1
	},
/obj/effect/turf_decal/stripes/white/line,
/obj/structure/sign/poster/random/directional/south,
/turf/open/floor/plating,
/area/station/hallway/secondary/entry)
"L" = (
/turf/open/floor/catwalk_floor,
/area/station/hallway/secondary/entry)
"M" = (
/obj/machinery/door/poddoor/shutters/indestructible/preopen{
	id = "this_one_is_open"
	},
/obj/structure/fluff/tram_rail/floor{
	dir = 1
	},
/obj/structure/fans/tiny/invisible,
/turf/open/floor/iron/dark/textured_large,
/area/station/hallway/secondary/entry)
"N" = (
/obj/machinery/door/airlock/grunge,
/obj/structure/fans/tiny/invisible,
/turf/open/floor/iron/dark/textured_large,
/area/station/hallway/secondary/entry)
"O" = (
/obj/structure/fluff/tram_rail/electric{
	dir = 1
	},
/obj/effect/turf_decal/stripes/white/line,
/obj/effect/spawner/random/structure/closet_empty/crate,
/turf/open/floor/plating,
/area/station/hallway/secondary/entry)
"P" = (
/obj/structure/railing{
	dir = 1
	},
/obj/machinery/light/small/red/directional/west,
/turf/open/floor/iron/smooth_half{
	dir = 1
	},
/area/station/hallway/secondary/entry)
"Q" = (
/turf/closed/indestructible/steel,
/area/station/hallway/secondary/entry)
"R" = (
/obj/structure/maintenance_loot_structure/wall_jacket/random/directional/north,
/turf/open/floor/iron/smooth_large,
/area/station/hallway/secondary/entry)
"S" = (
/obj/structure/fluff/tram_rail/electric,
/obj/effect/turf_decal/stripes/white/line{
	dir = 1
	},
/turf/open/floor/plating,
/area/station/hallway/secondary/entry)
"T" = (
/obj/structure/fluff/tram_rail/electric,
/obj/effect/turf_decal/stripes/white/line{
	dir = 1
	},
/obj/effect/spawner/random/structure/shipping_container,
/turf/open/floor/plating,
/area/station/hallway/secondary/entry)
"U" = (
/obj/effect/turf_decal/stripes/line{
	dir = 8
	},
/obj/effect/turf_decal/stripes/line{
	dir = 4
	},
/obj/machinery/door/poddoor/shutters/indestructible,
/turf/open/floor/engine,
/area/station/hallway/secondary/entry)
"W" = (
/obj/structure/railing{
	dir = 1
	},
/obj/machinery/light/small/red/directional/east,
/turf/open/floor/iron/smooth_half{
	dir = 1
	},
/area/station/hallway/secondary/entry)
"X" = (
/obj/effect/turf_decal/stripes/white/line{
	dir = 8
	},
/obj/machinery/light/small/red/directional/north,
/turf/open/floor/iron/smooth_half{
	dir = 1
	},
/area/station/hallway/secondary/entry)
"Y" = (
/obj/structure/fake_stairs/directional/north,
/obj/structure/railing{
	dir = 4
	},
/turf/open/floor/iron/smooth_large,
/area/station/hallway/secondary/entry)
"Z" = (
/obj/docking_port/stationary{
	dir = 8;
	dwidth = 1;
	height = 13;
	name = "arrivals";
	shuttle_id = "arrivals_stationary";
	width = 5
	},
/turf/open/floor/plating,
/area/station/hallway/secondary/entry)

(1,1,1) = {"
Q
Q
Q
Q
Q
Q
Q
Q
N
Q
d
f
M
Q
Q
Q
Q
Q
I
"}
(2,1,1) = {"
Q
U
U
U
U
U
Q
w
n
w
S
L
g
H
Q
a
a
a
Q
"}
(3,1,1) = {"
Q
m
B
B
B
z
Q
i
n
w
S
A
g
q
Q
a
a
a
Q
"}
(4,1,1) = {"
Q
s
s
s
s
s
Q
Q
e
w
y
L
t
Q
Q
a
a
a
Q
"}
(5,1,1) = {"
Q
s
s
s
s
s
P
o
n
H
S
L
g
H
Q
a
a
a
Q
"}
(6,1,1) = {"
Q
s
s
s
s
s
j
n
n
w
T
J
g
w
Q
a
a
a
Q
"}
(7,1,1) = {"
Q
s
s
s
s
s
Q
Q
G
w
y
J
t
Q
Q
a
a
a
Q
"}
(8,1,1) = {"
Q
s
s
s
s
s
Q
h
n
w
S
L
g
q
Q
a
a
a
Q
"}
(9,1,1) = {"
Q
s
s
s
s
s
Q
H
n
w
S
L
g
E
Q
a
a
a
Q
"}
(10,1,1) = {"
Q
s
s
s
s
s
Q
Q
N
Q
d
f
M
Q
Q
a
a
a
Q
"}
(11,1,1) = {"
Q
s
s
s
s
s
Q
c
n
w
S
L
g
w
Q
a
a
a
Q
"}
(12,1,1) = {"
Q
s
s
s
s
s
Q
x
k
H
S
L
g
F
Q
a
a
a
Q
"}
(13,1,1) = {"
Q
s
s
s
s
s
Q
Q
R
H
D
L
K
Q
Q
a
a
a
Q
"}
(14,1,1) = {"
Q
s
s
s
s
s
Y
n
n
w
S
L
O
w
Q
a
a
a
Q
"}
(15,1,1) = {"
Q
s
s
s
s
s
W
l
n
w
S
L
g
H
Q
a
a
a
Q
"}
(16,1,1) = {"
Q
s
s
s
Z
s
Q
Q
G
w
y
L
t
Q
Q
a
a
a
Q
"}
(17,1,1) = {"
Q
X
v
v
v
r
Q
h
n
H
S
L
O
F
Q
a
a
a
Q
"}
(18,1,1) = {"
Q
U
U
U
U
U
Q
w
n
w
S
L
g
E
Q
a
a
a
Q
"}
(19,1,1) = {"
Q
Q
Q
Q
Q
Q
Q
Q
N
Q
d
f
M
Q
Q
Q
Q
Q
Q
"}
